#################
#A             #
### ##### #######
#   #     #     #
# ### ### # ### #
# #   # # # # # #
# # ### # # # # #
# # #   # # # # #
# # # ### # # # #
# # # #   # # # #
# # # # ### # # #
# # # # #   # # #
# # # # # ### # #
# # #   #     #B#
#################
