A  ██████████████████████████████████████████████████████████
   █              █              █        █        █  █     █
█  █  ████  █  █  █  █  █  █  ██████████  █  █  ████  ████  █
█     █     █  █  █  █  █  █     █     █  █  █           █  █
███████  █  ██████████  ████  ███████  █  ██████████  ████  █
█        █     █     █  █     █           █                 █
█  ██████████  ████  █  ████  █  ████  ███████  █  ████  █  █
█        █        █  █  █  █  █  █        █     █     █  █  █
████  █  ██████████  █  █  █  ██████████  █  ████  ██████████
█     █  █     █        █                 █  █     █  █     █
█  ████  █  █  ████  ███████  ████  ████  ███████  █  █  ████
█     █     █  █           █  █     █     █           █  █  █
█  ████  ████  ████  █  ████████████████  ████  █  █  █  █  █
█     █     █     █  █        █  █  █        █  █  █        █
█  ████  ███████  █  ██████████  █  █  █  ███████  ████  ████
█     █  █           █  █  █  █        █  █        █  █     █
█████████████  ███████  █  █  █████████████  ███████  ███████
█        █  █              █     █  █        █        █     █
███████  █  ███████  ████  █  ████  ████  █  ███████  █  █  █
█              █     █  █     █  █     █  █        █     █  █
█  ████  ████  ████  █  ███████  ████  █  ███████  █  █  ████
█     █  █              █        █  █  █     █     █  █  █  █
█  ████  █  █  █████████████  ████  █  █  █  ████  █  ████  █
█     █  █  █     █     █  █  █  █        █  █  █     █     █
████  █████████████  █  █  █  █  █  ███████  █  ████  █  ████
█        █  █        █           █  █     █     █     █     █
█  ████  █  █  ██████████  ████  █  █  ████  ████  █  █  █  █
█  █  █                 █  █        █  █        █  █  █  █  █
████  █  ████  ████  ██████████  █  █  ███████  ████  ████  █
█  █     █  █  █  █     █     █  █  █           █  █  █  █  █
█  ████  █  █  █  ███████  ████  ███████  ███████  █  █  █  █
█  █        █  █  █  █     █           █        █        █  █
█  █  █  ███████  █  ████  ████  ████████████████  ███████  █
█  █  █  █        █     █        █     █  █     █     █     █
█  █  ████  ██████████  ████  ███████  █  █  ███████  ████  █
█              █     █  █        █     █                    █
█  ████  █  █  █  █  █  ███████  ████  █  ██████████  ████  █
█     █  █  █     █  █        █  █     █        █     █     █
████  ████  ██████████  █  ████  █  █  ██████████  ████  ████
█     █        █        █           █        █        █     
██████████████████████████████████████████████████████████  B