A  ████████████████████████████████████████████████████████████████████████████████████████████████████████████████████████████████████████████████████
      █     █     █        █  █  █     █  █        █        █     █              █                 █  █     █     █        █     █  █           █     █
█  ████  ███████  █  ████  █  █  ████  █  █  ███████  ████  ████  █  █  ████  ███████  ███████  █  █  ████  █  █  █  ██████████  █  █  ████  █  █  ████
█     █           █  █        █  █        █  █        █     █     █  █  █  █  █     █  █  █     █     █  █     █  █  █  █  █        █  █     █  █     █
████  █  ████  ██████████  █  █  ███████  █  ███████  ████  █  █  █  ████  █  █  ████  █  ███████  ████  ████  ████  █  █  ████  █  █  █  ████  █  ████
█  █  █  █                 █     █              █        █  █  █     █     █  █     █  █           █  █                       █  █  █  █  █           █
█  █  █  ██████████████████████  ████  █████████████  █  █  █  ████  ████  █  █  █  █████████████  █  ███████  █  ████  ██████████  █  █████████████  █
█        █        █  █           █              █     █  █  █     █     █  █     █     █  █  █        █     █  █  █  █  █  █              █  █  █  █  █
█  ███████  ███████  ███████  █  █  █  █  ██████████  █████████████  ████  █  ██████████  █  █  █  ███████  █  ████  ████  ████  █  ███████  █  █  ████
█  █                 █  █     █  █  █  █     █     █  █  █     █     █  █     █  █  █           █        █        █     █  █     █     █     █        █
█  ███████  ██████████  █  █  █  ████  ████  █  ████  █  ████  ████  █  █  ████  █  ████  ██████████  █  ████  █  ████  █  ████  ████  █  ██████████  █
█     █        █           █  █     █  █  █  █  █     █        █     █              █        █        █  █     █     █        █  █        █  █  █     █
█  █  █  ███████  █  █  █  ████  █  ████  █  █  ████  ████  ███████  ████████████████  ████  █████████████  ███████  ███████  █  █  █  ████  █  ████  █
█  █  █  █  █  █  █  █  █     █  █     █        █  █        █           █  █        █  █  █           █        █     █     █     █  █           █  █  █
███████  █  █  ████  ███████  ████  █  ████  ████  █  ████  █  █  ████  █  ███████  ████  ████  █  ███████  █  ███████  █████████████  ████  ████  █  █
█              █        █  █  █  █  █                    █  █  █     █  █           █     █     █     █  █  █        █     █  █  █        █           █
██████████  █  █  █  ████  ████  ████  ████████████████  ██████████  █  ████  ████  █  █  █  ████  ████  ███████  ████  ████  █  █  ████  █  ██████████
█     █     █  █  █        █           █     █  █        █           █           █     █     █     █  █        █  █                 █     █  █        █
█  ████  █████████████  ████████████████  ████  ██████████  █████████████  ████  █  █  █  ███████  █  ████  ████  █  ███████  ███████  ███████  █  █  █
█  █        █     █        █  █           █  █     █                 █        █  █  █  █  █                       █  █  █        █        █  █  █  █  █
█  █  █  ████  ███████  ████  ██████████  █  █  ███████  █  █  ████  ████  █  █  ███████  ███████  ████  █████████████  ███████  ████  ████  ███████  █
█     █        █              █  █     █           █  █  █  █  █     █     █  █  █  █     █     █     █  █        █           █  █     █           █  █
█  ████  █  █  █████████████  █  █  ██████████  ████  ███████  █  ████████████████  ███████  ███████  ███████  ████  █  ███████  ████  ████  ███████  █
█  █     █  █  █        █                       █     █     █  █  █  █  █     █  █        █     █     █  █     █  █  █  █     █  █     █  █  █        █
█  ████  ████  █  █  ████  █  █  ████████████████  ████  ███████  █  █  █  ████  █  ███████  ███████  █  █  █  █  █  █  ████  █  ███████  █  ████  █  █
█  █  █     █     █     █  █  █  █  █  █        █  █           █  █        █     █           █  █  █  █  █  █     █  █           █           █     █  █
████  █  █████████████  █  █  █  █  █  █  █  ████  █  ███████  █  ████  ███████  █  ██████████  █  █  █  ████  ██████████  ███████  ████  ████  ████  █
█           █        █     █  █     █     █     █  █     █     █  █  █        █  █        █  █           █     █              █  █  █  █  █  █  █  █  █
█  ███████  █  ████  ████  ███████  ████  ████  █  ███████  █  ████  ████  ████  █  ███████  █  ████  █  █  █  █████████████  █  ████  █  █  █  █  ████
█        █  █  █        █  █        █  █     █  █  █     █  █        █  █  █  █        █     █  █     █  █  █        █           █     █              █
█  ███████████████████  ████  █  ████  █  █  ████  ████  █  █  ███████  █  █  ████  ████  ████  ██████████  ████  █  █  ████  █  █  ███████  █  ███████
█  █                       █  █        █  █           █     █                 █  █     █  █              █  █     █  █  █     █        █     █        █
█  ██████████  █  █  █  █  ██████████  ███████  ███████  █  █  ███████  █  ████  █  ████  ████  █  █████████████  █████████████  ████  █  ██████████  █
█  █        █  █  █  █  █     █  █        █           █  █  █     █     █  █     █              █              █  █        █     █        █  █  █     █
█  ████  ████  ████  █  ███████  ████  ███████  █  █  █  ████████████████  ████  █  ███████  ████  ██████████  █  █  ████  ███████  █  █  █  █  ███████
█     █     █  █  █  █  █     █  █  █           █  █     █              █           █        █  █  █  █              █  █  █  █  █  █  █  █           █
█  ████  ████  █  █  ████  ████  █  █  ████  ███████  ████  █  █  █  ████████████████  ███████  ████  █  ███████  ████  █  █  █  █  ███████  ███████  █
█        █     █  █     █        █     █  █  █        █     █  █  █     █           █              █           █  █     █     █  █     █     █     █  █
████  ██████████  █  ████  ████  █  ████  ████  ████  ████  ████  ███████  █  █  █  ████  ████  █  ████  ███████  █  ███████  █  ████  ████  █  █  ████
█     █  █              █     █        █           █  █  █  █        █     █  █  █     █  █  █  █  █  █  █     █  █     █     █        █     █  █     █
████  █  █  ████  █  ████  ████  ███████  █████████████  █  ████  ████  ███████  ████  █  █  ███████  ████  ████  █  ████  ███████  ████  █  █  ███████
█              █  █  █        █  █        █        █        █        █     █     █              █        █           █  █     █  █     █  █        █  █
█  █  ████  █  ███████  █████████████  ████  ████  ████  ████  ████  ███████  ████  █  ████  ████  ████  █  ████  █  █  ███████  █  █  ██████████  █  █
█  █  █     █  █           █        █     █  █  █  █        █  █     █        █  █  █     █  █  █     █     █     █  █     █        █  █              █
█  █  █████████████  ██████████  ███████  █  █  █  █  ██████████  ███████  ████  ████  ███████  █  ████  ████  ████  █  ███████  ████  █  █  █  ███████
█  █  █        █        █     █              █  █  █     █  █        █     █  █                 █  █        █  █  █  █  █           █     █  █     █  █
█  █  ████  █  ████  ███████  █  ██████████  █  ██████████  ████  ████  █  █  ███████  ███████  ████  █  ████  █  ████  ████  █  ███████  ████  ████  █
█  █     █  █        █        █  █  █  █           █           █     █  █     █           █  █  █  █  █     █     █     █  █  █     █        █  █     █
█  █████████████  ████  █  ███████  █  ████  ████  █  ██████████  █  ███████  █  █  █  █  █  ████  ████  ██████████  ████  ████  ████  ██████████  ████
█  █     █  █           █     █        █  █     █  █     █        █  █        █  █  █  █  █                 █  █     █        █  █  █           █     █
█  █  ████  █  █  ████████████████  ████  ███████  ████  ███████  ███████  █  ████  ████  ████  █  █  █  █  █  █  ███████  ███████  ████  █  █  ████  █
█  █     █  █  █  █                 █     █        █  █     █  █        █  █     █  █  █  █     █  █  █  █     █                       █  █  █        █
█  █  ████  ██████████  █  ███████  ████  █  ███████  █  ████  █  ███████████████████  █  ████  ████  ███████  █  ██████████  ██████████  █  ███████  █
█     █              █  █     █  █  █     █              █        █     █     █        █  █     █     █  █           █  █        █     █  █     █     █
█  ████  ███████  ████  ████  █  █  █  █  ████  █  █  █  █  ████  █  ████  ████  ███████  ████  ███████  ████  █  ████  ████  ███████  ███████  ███████
█     █  █  █  █     █  █  █     █     █        █  █  █  █  █                    █     █     █  █  █           █  █     █        █  █     █     █  █  █
████  █  █  █  ████  █  █  █  █  ████  ████  █  ███████  █  █  ████  █  ████  ███████  ██████████  ████  █  ███████  ███████  ████  █  █  █  █  █  █  █
█     █  █     █     █     █  █  █  █     █  █        █     █  █  █  █  █     █  █  █           █        █  █     █     █  █           █  █  █  █     █
████  █  ████  █  ███████  █  ████  █  ████  █  ████  █  █  ████  █  ███████  █  █  █  ███████  █████████████  █  █  ████  ███████  █  █  █  █  █  ████
█     █  █     █     █     █        █     █  █     █  █  █  █           █     █        █        █        █     █  █           █     █  █     █  █  █  █
████  █  █  █  ███████  █  ███████  ██████████████████████  █  █  ███████  ████  ██████████  ████  █  ████  ████  █  ███████  █  █  ████  ███████  █  █
█  █  █     █        █  █  █              █  █  █  █  █  █  █  █  █           █  █              █  █        █     █        █     █  █  █        █     █
█  █  ████  ████  ████  ███████████████████  █  █  █  █  ███████  █  █  ████  ████  ███████████████████  ████  ████  █  █  █  ███████  ████  █  █  ████
█        █  █        █  █           █  █        █  █           █  █  █     █        █        █  █        █           █  █  █     █        █  █        █
█  █  ███████  ████  ████  ███████  █  ███████  █  ██████████  █  ██████████████████████  █  █  █  █  ███████  █████████████████████████  ████  ███████
█  █  █        █        █  █     █     █     █        █     █              █  █           █  █  █  █  █        █        █     █  █  █  █     █        █
████  ███████  ████  █  █  █  ██████████  ███████  ████  █  █  ███████  ████  █  █  ████  ████  ███████  ██████████  ████  █  █  █  █  █  ███████  ████
█        █     █     █  █           █  █  █     █  █     █  █  █        █        █  █        █        █  █     █     █  █  █  █  █  █     █     █     █
█  █  █████████████  █  ██████████  █  █  █  ████  █  ████  █  ███████  ███████████████████  ███████  █  ████  █  █  █  █  ████  █  █  ███████  ███████
█  █     █     █  █  █                       █  █        █        █  █     █  █  █     █        █                 █     █        █  █           █     █
███████  ████  █  █  █████████████  ████  █  █  █  ████  █  █  █  █  ████  █  █  ████  ████  ██████████  ███████  ███████  ███████  █  █  █  ████  █  █
█     █  █        █  █  █  █           █  █  █  █  █  █  █  █  █  █        █           █           █  █        █     █        █        █  █  █     █  █
█  ████  ████  █  ████  █  ████  ████  ███████  ████  █  █  ██████████  ████  █  ████  ████  ████  █  ████  █  ██████████  ███████  ████  █  █  █  █  █
█  █  █        █                 █              █     █  █           █     █  █  █     █  █     █        █  █           █  █  █     █  █  █     █  █  █
█  █  ████  █  ████  ███████  ███████  █  █  █  █  █  ████  █  █  █  ████  █  ████  █  █  ███████  ████  ████  ██████████  █  █  █  █  █  ██████████  █
█           █     █  █              █  █  █  █     █     █  █  █  █  █     █  █     █  █           █                    █  █  █  █     █        █     █
█████████████  █████████████  █  ██████████  █  █  ██████████  ██████████  ████  ████  █  ██████████  █  █  ████  ███████  █  ████  █  █  █  ██████████
█  █  █              █     █  █     █  █  █  █  █  █     █     █  █  █     █  █  █  █           █     █  █  █           █           █  █  █        █  █
█  █  █  █  █  ████  █  ████  ███████  █  ██████████  ████  ████  █  █  ████  █  █  ███████████████████  █  ████  ████  █  ███████  █████████████  █  █
█  █  █  █  █     █  █     █              █     █           █     █           █  █     █              █  █     █  █           █  █  █  █     █  █     █
█  █  █  ████  ███████  ██████████  ███████  ███████  ████  ████  ████  ████  ███████  █  ████  █  █  ███████  █  ███████  ████  ████  █  ████  ███████
█     █     █     █  █           █  █     █           █     █           █  █     █        █  █  █  █     █     █  █                          █  █  █  █
████  ███████  ████  █  █████████████  ████  ███████  █  █  ████  ███████  ██████████  █  █  ██████████  █  ████  █  █  █████████████  ███████  █  █  █
█  █     █  █        █        █     █     █  █  █     █  █  █  █     █     █  █        █     █              █  █  █  █  █  █        █     █           █
█  █  ████  █  ██████████  ████  ████  ███████  █  █  ███████  █  ████  ████  █  █  ███████  █  ███████  ████  ████  ████  █  ████  ███████  █  ███████
█     █  █     █  █  █     █  █  █     █     █     █  █     █     █     █        █     █     █  █     █  █     █  █              █  █  █     █        █
█  █  █  ████  █  █  ████  █  █  █  █  █  █  ████  █  ████  ████  █  █  ███████  ███████  ██████████  █  █  █  █  ███████  ████  ████  █  ████  ███████
█  █  █           █        █  █     █     █  █     █  █              █     █     █  █  █     █        █     █  █           █  █  █  █     █        █  █
████  █  █  ███████  ████  █  █  █  ███████  ████  ████  ████  █  ██████████  █  █  █  █████████████  █  ████  ███████  ████  ████  █  ███████  ████  █
█  █  █  █     █  █  █           █        █           █     █  █        █     █        █              █     █  █  █        █  █     █     █  █        █
█  █  █  ████  █  █  ████  █  █  ███████  █████████████  ████  █  ████  █  ████████████████  ███████  █  █  ████  ████  ████  ████  ████  █  ██████████
█  █     █     █     █     █  █     █     █     █     █  █  █  █  █     █  █  █  █     █           █     █  █  █        █  █     █  █  █  █           █
█  ██████████  ██████████  █  ███████  ████  ███████  █  █  ████  █  █  ████  █  ████  ██████████████████████  ████  ████  █  ████  █  █  ████  █  █  █
█  █  █        █  █        █  █           █  █  █           █     █  █     █           █  █     █  █     █        █        █              █  █  █  █  █
█  █  █  █  ████  ███████  █  ███████  ████  █  █  ███████  █  ██████████  ██████████  █  █  ████  █  ████  █  █  █  ████  █  ████  ███████  █  ███████
█        █     █        █  █     █              █     █     █     █           █        █  █     █     █     █  █        █        █           █     █  █
█████████████  ████  █████████████  ████  █  ███████  █  ███████████████████  █  █  █  █  █  █  █  ████  ███████  ██████████  ███████  ████  █  ████  █
█     █  █  █     █        █     █     █  █  █     █  █  █        █  █     █     █  █     █  █     █  █  █           █  █  █     █     █        █  █  █
█  ████  █  ████  ███████  █  ████  ████  ████  ████  █  ████  █  █  █  ████  ███████  █  █  ███████  █  ████  █  ████  █  █  ████  ████  ████  █  █  █
█                       █           █              █  █     █  █                 █     █  █              █     █        █        █  █     █           
████████████████████████████████████████████████████████████████████████████████████████████████████████████████████████████████████████████████████  B